
ภาคใต้

ภูเก็ต: หาดป่าตอง, แหลมพรหมเทพ, เมืองเก่าภูเก็ต, วัดฉลอง, เกาะพีพี (อยู่ในเขตจังหวัดกระบี่แต่เดินทางจากภูเก็ตได้สะดวก)

กระบี่: หาดไร่เลย์, อ่าวมาหยา, สระมรกต, เกาะไก่, เกาะห้อง

พังงา: เกาะตาปู (เขาพิงกัน), อุทยานแห่งชาติหมู่เกาะสิมิลัน, อุทยานแห่งชาติอ่าวพังงา, เกาะสุรินทร์, เขาหลัก

สุราษฎร์ธานี: เกาะสมุย, เกาะพะงัน, เขื่อนเชี่ยวหลาน (กุ้ยหลินเมืองไทย), อุทยานแห่งชาติหมู่เกาะอ่างทอง, หาดเฉวง

นครศรีธรรมราช: วัดพระมหาธาตุวรมหาวิหาร, ขนอม, หมู่บ้านคีรีวง, น้ำตกพรหมโลก, หาดทรายแก้ว

สงขลา: หาดสมิหลา, เมืองเก่าสงขลา, เขาตังกวน, วัดมัชฌิมาวาส (วัดกลาง), สวนสัตว์สงขลา

พัทลุง: ถ้ำเขาอกทะลุ, ทะเลน้อย, น้ำตกไพรวัลย์, วังเจ้าเมืองพัทลุง, วัดเขียนบางแก้ว

ตรัง: ถ้ำมรกต, เกาะกระดาน, หาดปากเมง, สถานีรถไฟกันตัง, วนอุทยานบ่อน้ำร้อนกันตัง

สตูล: เกาะหลีเป๊ะ, อุทยานแห่งชาติตะรุเตา, หาดใหญ่, ถ้ำเล สเตโกดอน, อุทยานแห่งชาติหมู่เกาะเภตรา

นราธิวาส: มัสยิดกลางจังหวัดนราธิวาส, อุทยานแห่งชาติบูโด-สุไหงปาดี, หาดนราทัศน์, พระพุทธทักษิณมิ่งมงคล, น้ำตกฉัตรวาริน

ยะลา: อุโมงค์ปิยะมิตร, ทะเลหมอกอัยเยอร์เวง, วัดคูหาภิมุข (วัดหน้าถ้ำ), เขื่อนบางลาง, สวนขวัญเมือง

ปัตตานี: มัสยิดกรือเซะ, หาดรูสะมิแล, สวนสมเด็จพระศรีนครินทร์ ปัตตานี, ศาลเจ้าเล่งจูเกียง, วัดช้างให้

ระนอง: บ่อน้ำร้อนรักษะวาริน, ภูเขาหญ้า, เกาะพยาม, แกรนด์แคนยอนระนอง, จุดชมวิวสองแคว

ชุมพร: หาดทรายรี, เกาะลังกาจิว, อุทยานแห่งชาติหมู่เกาะชุมพร, จุดชมวิวเขามัทรี, ถ้ำเขาพลู

สุโขทัย: อุทยานประวัติศาสตร์สุโขทัย, วัดศรีชุม, วัดมหาธาตุ, เมืองเก่าสุโขทัย

กำแพงเพชร: อุทยานประวัติศาสตร์กำแพงเพชร, วัดพระบรมธาตุ, บ่อน้ำพุพระร่วง, ตลาดริมปิง

พิจิตร: วัดท่าหลวง, บึงสีไฟ, อุทยานเมืองเก่าพิจิตร, วัดโพธิ์ประทับช้าง, ถ้ำชาละวัน

พิษณุโลก: วัดพระศรีรัตนมหาธาตุวรมหาวิหาร (วัดใหญ่), พระราชวังจันทน์, อุทยานแห่งชาติภูหินร่องกล้า, น้ำตกชาติตระการ

เพชรบูรณ์: อุทยานแห่งชาติเขาค้อ, พระธาตุผาซ่อนแก้ว, ภูทับเบิก, อุทยานแห่งชาติทุ่งแสลงหลวง, ไร่ GB

ภาคตะวันออก 

ปราจีนบุรี: อุทยานแห่งชาติเขาใหญ่ (ส่วนที่อยู่ในปราจีนบุรี), วัดแก้วพิจิตร, ต้นศรีมหาโพธิ์, น้ำตกเขาอีโต้

สระแก้ว: ปราสาทสด๊กก๊อกธม, ละลุ, ตลาดโรงเกลือ, อุทยานแห่งชาติปางสีดา, เขาฉกรรจ์

ชลบุรี: หาดบางแสน, เกาะล้าน, ตลาดหนองมน, เขาชีจรรย์, สวนนงนุช, อันเดอร์วอเตอร์เวิลด์ พัทยา

ระยอง: เกาะเสม็ด, ทุ่งโปรงทอง, หาดแม่รำพึง, สวนสน, เขาแหลมหญ้า

จันทบุรี: โบสถ์คริสต์จันทบุรี, หาดเจ้าหลาว, น้ำตกพลิ้ว, อ่าวคุ้งกระเบน, ตลาดพลอย

ตราด: เกาะช้าง, เกาะกูด, เกาะหมาก, หาดทรายดำ, จุดชมวิวเขา

ภาคตะวันออกเฉียงเหนือ

เลย: ภูกระดึง, เชียงคาน, พระธาตุศรีสองรัก, ภูทอก, อุทยานแห่งชาติภูเรือ, แก่งคุดคู้

นครราชสีมา: อุทยานแห่งชาติเขาใหญ่, วัดหลวงพ่อโต (วัดสรพงษ์), ผาเก็บตะวัน, ฟาร์มโชคชัย, ปราสาทหินพิมาย, แหล่งโบราณคดีบ้านปราสาท, เดอะ บลูม บาย ทีวีพูล

บุรีรัมย์: อุทยานประวัติศาสตร์พนมรุ้ง, สนามช้างอารีนา, เขื่อนลำนางรอง, วนอุทยานเขากระโดง, ปราสาทเมืองต่ำ, เพ ลา เพลิน

สุรินทร์: ปราสาทศีขรภูมิ, หมู่บ้านช้าง, วัดบูรพาราม, ปราสาทบ้านพลวง, วนอุทยานพนมสวาย

ศรีสะเกษ: ผามออีแดง, วัดมหาเจดีย์แก้ว (วัดล้านขวด), ปราสาทสระกำแพงใหญ่, น้ำตกสำโรงเกียรติ, วัดพระธาตุเรืองรอง, สวนสมเด็จศรีนครินทร์ศรีสะเกษ

มหาสารคาม: พระธาตุนาดูน, วนอุทยานโกสัมพี, แก่งเลิงจาน, สะพานไม้แก่งเลิงจาน, สวนสาธารณะหนองข่า

ร้อยเอ็ด: พระมหาเจดีย์ชัยมงคล, บึงพลาญชัย, วัดบูรพาภิราม, เมืองโบราณหนองหงส์, วัดผาน้ำย้อย

ขอนแก่น: พระมหาธาตุแก่นนคร (วัดหนองแวง), อุทยานแห่งชาติภูเวียง, เขื่อนอุบลรัตน์, พิพิธภัณฑ์ไดโนเสาร์ภูเวียง, วัดป่าคำชะโนด, สวนสัตว์ขอนแก่น

อุดรธานี: ทะเลบัวแดง, วัดป่าภูก้อน, อุทยานประวัติศาสตร์ภูพระบาท, คำชะโนด, พิพิธภัณฑ์สถานแห่งชาติบ้านเชียง, วังนาคินทร์คำชะโนด

หนองบัวลำภู: อุทยานแห่งชาติภูเก้า-ภูพานคำ, วังแก้ว, ถ้ำเอราวัณ, หนองบัว

สกลนคร: พระธาตุเชิงชุมวรวิหาร, หนองหาร, วัดถ้ำผาแด่น, วัดพระธาตุนารายณ์เจงเวง, อุทยานแห่งชาติภูพาน

นครพนม: พระธาตุพนม, พญาศรีสัตตนาคราช, วัดนักบุญอันนา หนองแสง, สะพานมิตรภาพไทย-ลาว แห่งที่ 3, วัดพระธาตุประสิทธิ์

มุกดาหาร: อุทยานแห่งชาติภูผาเทิบ, สะพานมิตรภาพไทย-ลาว แห่งที่ 2, หอแก้วมุกดาหาร, แก่งกะเบา, วัดรอยพระพุทธบาทภูมโนรมย์

กาฬสินธุ์: เขื่อนลำปาว, พิพิธภัณฑ์สิรินธร, วนอุทยานภูแฝก, พระธาตุยาคู, วัดสว่างอารมณ์ (วัดป่าดงสว่าง)

บึงกาฬ: หินสามวาฬ, ภูสิงห์, น้ำตกเจ็ดสี, วัดอาฮงศิลาวาส

ชัยภูมิ: อุทยานแห่งชาติป่าหินงาม, มอหินขาว, ผาเกิ้ง, น้ำตกตาดโตน

ยโสธร: พระธาตุอานนท์, เมืองเก่าบ้านสิงห์ท่า, วัดพระพุทธบาทยโสธร, วนอุทยานดงฟ้าห่วน, พิพิธภัณฑ์พญาคันคาก

อำนาจเจริญ: พระมงคลมิ่งเมือง, พุทธอุทยาน, วัดถ้ำแสงเพชร, อ่างเก็บน้ำพ

ภาคกลาง

กรุงเทพมหานคร: วัดพระแก้ว, พระบรมมหาราชวัง, วัดอรุณราชวรารามราชวรมหาวิหาร, วัดโพธิ์, เยาวราช, ถนนข้าวสาร, สยาม, ไอคอนสยาม, จิม ทอมป์สัน เฮาส์

พระนครศรีอยุธยา: อุทยานประวัติศาสตร์พระนครศรีอยุธยา (วัดใหญ่ชัยมงคล, วัดพระศรีสรรเพชญ์, วัดมหาธาตุ), ตลาดน้ำอโยธยา, วัดพนัญเชิงวรวิหาร, พระราชวังบางปะอิน

สุพรรณบุรี: วัดป่าเลไลยก์วรวิหาร, ตลาดสามชุกร้อยปี, อุทยานมังกรสวรรค์ (ศาลเจ้าพ่อหลักเมืองสุพรรณบุรี), บึงฉวากเฉลิมพระเกียรติ

กาญจนบุรี: สะพานข้ามแม่น้ำแคว, อุทยานแห่งชาติเอราวัณ, เมืองมัลลิกา ร.ศ. 124, ปราสาทเมืองสิงห์, ช่องเขาขาด

ราชบุรี: ตลาดน้ำดำเนินสะดวก, สวนผึ้ง, ถ้ำเขาบิน, วัดมหาธาตุวรวิหาร, โป่งยุบ

นครปฐม: พระปฐมเจดีย์, ตลาดน้ำดอนหวาย, พระราชวังสนามจันทร์, วัดไร่ขิง, พิพิธภัณฑ์หุ่นขี้ผึ้งไทย

สมุทรสาคร: วัดโกรกกราก, ตลาดทะเลไทย, ป้อมวิเชียรโชฎก, ศาลพันท้ายนรสิงห์

สมุทรสงคราม: ตลาดร่มหุบ, วัดเพชรสมุทรวรวิหาร (วัดหลวงพ่อบ้านแหลม), อัมพวา, อุทยาน ร.2, ค่ายบางกุ้ง

เพชรบุรี: พระราชวังมฤคทายวัน, หาดชะอำ, อุทยานแห่งชาติแก่งกระจาน, เขาวัง (พระนครคีรี), หาดเจ้าสำราญ

ประจวบคีรีขันธ์: หัวหิน, เขาตะเกียบ, อุทยานแห่งชาติเขาสามร้อยยอด, วนอุทยานปราณบุรี, ตลาดโต้รุ่งหัวหิน

ชัยนาท: วัดพระบรมธาตุวรวิหาร, สวนนกชัยนาท, เขื่อนเจ้าพระยา, วัดปากคลองมะขามเฒ่า, วัดทรงธรรม

สิงห์บุรี: วัดพระนอนจักรสีห์วรวิหาร, อนุสาวรีย์วีรชนค่ายบางระจัน, ตลาดไทยย้อนยุคบ้านระจัน, วัดอัมพวัน, วัดพิกุลทอง

อ่างทอง: วัดม่วง, วัดขุนอินทประมูล, ตลาดอ่างทอง, วัดไชโยวรวิหาร, บ้านหุ่นเหล็ก

ลพบุรี: พระปรางค์สามยอด, วังนารายณ์ราชนิเวศน์, เขื่อนป่าสักชลสิทธิ์, ทุ่งทานตะวัน, วัดเขาสนามแจง

สระบุรี: น้ำตกเจ็ดคต, วัดพระพุทธบาทราชวรมหาวิหาร, ไร่องุ่น PB Valley Khao Yai Winery, อุทยานแห่งชาติน้ำตกสามหลั่น, ตลาดหัวปลี

นครสวรรค์: วัดคีรีวงศ์, ต้นแม่น้ำเจ้าพระยา, บึงบอระเพ็ด, วัดวรนาถ, พาสาน

อุทัยธานี: วัดท่าซุง (วัดจันทาราม), หุบป่าตาด, เขาPluto, วัดสังกัสรัตนคีรี, ตลาดซาวไฮ่

ภาคเหนือ

เชียงใหม่: วัดพระธาตุดอยสุเทพ, ถนนคนเดินท่าแพ, ดอยอินทนนท์, พระตำหนักภูพิงคราชนิเวศน์, เวียงกุมกาม, แกรนด์แคนยอนเชียงใหม่, ห้วยตึงเฒ่า, ม่อนแจ่ม

เชียงราย: วัดร่องขุ่น, ไร่ชาฉุยฟง, ดอยแม่สลอง, สิงห์ปาร์ค เชียงราย, พระธาตุดอยตุง, สามเหลี่ยมทองคำ, ขุนกรณ์, ภูชี้ฟ้า

แม่ฮ่องสอน: ปาย, วัดพระธาตุดอยกองมู, บ้านรักไทย, ถ้ำลอด, ปางอุ๋ง, สะพานซูตองเป้, ถนนคนเดินปาย, กองแลน (ปายแคนยอน)

ลำปาง: วัดพระธาตุลำปางหลวง, กาดกองต้า, อุทยานแห่งชาติแจ้ซ้อน, สะพานรัษฎาภิเศก, ถนนคนเดินกาดกองต้า, วัดศรีรองเมือง, วัดพระแก้วดอนเต้าสุชาดาราม

ลำพูน: วัดพระธาตุหริภุญชัยวรมหาวิหาร, วัดจามเทวี (วัดกู่กุด), อุทยานแห่งชาติดอยขุนตาล, พิพิธภัณฑสถานแห่งชาติหริภุญไชย, วัดมหาวัน, วัดสันป่ายางหลวง

พะเยา: กว๊านพะเยา, วัดอนาลโยทิพยาราม, อุทยานแห่งชาติดอยหลวง, วัดพระธาตุจอมทอง, วัดศรีโคมคำ, ภูลังกา

น่าน: วัดพระธาตุแช่แห้ง, ดอยเสมอดาว, อุทยานแห่งชาติขุนน่าน, ถนนคนเดินน่าน, หอศิลป์ริมน่าน, วัดภูมินทร์, บ่อเกลือสินเธาว์

แพร่: วัดพระธาตุช่อแฮ, คุ้มเจ้าหลวง, แพะเมืองผี, บ้านวงศ์บุรี, วัดจอมสวรรค์, พระธาตุอินทร์แขวนจำลอง (วัดพระธาตุสุโทนมงคลคีรี)

ตาก: เขื่อนภูมิพล, อุทยานแห่งชาติตากสินมหาราช, ดอยมูเซอ, ตลาดริมเมย, น้ำตกทีลอซู